111111111111111111111
100N0000000000000001
100000100000001111111
100100000000000000001
100001111111111111111
111111